50
11111111111111111111111111111111111111111111111111
10001000100100001000001000000001000000010000010001
10000000000100000000000000001000000101000100010011
10000000100000001000000000000000000101000000000001
10000000100010000010000000001000000000000010011001
10000010000010000010000000000000000011001010010001
10100000110010000010000000000000001000001000000001
10100000000010000000000000000000000000001010000001
10000001000000000100100000000000000000000000000001
10100000010000010000000001000000000000000010100001
10000000010000000000000000000000000000000000100001
10100000011000011100000100000110000011100000100101
10000000110000000000000000000100000000000000000001
10000000000000000000000000000000100000010000000001
10000000000010000000000101000000000000000000011011
11100000001010100000100000001000100000000001011001
10000000000010000000000100000000000000100001010001
10100011110000000000100000000000000000000100000001
10000000010000000000000000000011100000000100000001
11000000000011000000000101001001000001000000000001
10000000000010000000000000000000000000001000000001
10000000000011000000000100000110000000000000000001
10000100100110000001000000000000000000000010000001
10000000000000000000000100100000000100000011000001
10100000000000000000010000001000000000101011000001
11100000000000000001000000000000011000100000011001
10000000000000001001000110100000000000000000010001
10000010001010000000000000001000101000000000000001
11000000000000100000001000000010000001000000000001
10000000001000000000100000000010000000010000100101
11000000000000001000000000000000010000000100000001
11010000000010000000000000000000000100000001010001
10000000001000000000000100000100000001000100000001
11100000100001000000010100000000000000010100000011
10001000000000000000000000000000000001000100001001
10000000000000000000000000000010001000000000000001
10010100000000000000000100000000000000000100000011
10010001000000000000010000000000000000000000000001
10000001000001110000000000001000100000100001100011
10000000000000000010000010000010001000000000000001
10000000000000000000000010000000000000000101000001
10000000000000000001000000000000000000000000000001
11000100101000000000000000000000100010000000100001
10000000000000011000000000100100000000000000000001
10000000000000001000000000000000000000001100000011
10000001000001000000000000000000010000000110000001
11000000000100000100000000000000000000000000000001
10001000000000000000100100000000000001001000000001
10000000000001000010000000001000001001000000100111
11111111111111111111111111111111111111111111111111
