20 20
0 0 0 0 0 0 0 0 0 0 0 0 0 0 0 0 0 0 0 2
0 1 1 1 0 1 1 1 0 1 1 1 0 1 1 1 0 1 1 1
0 1 2 1 0 1 2 1 0 1 2 1 0 1 2 1 0 1 2 2
0 1 0 1 0 1 0 1 0 1 0 1 0 1 0 1 0 1 0 0
0 1 0 1 0 1 0 1 0 1 0 1 0 1 0 1 0 1 0 0
0 1 0 1 0 1 0 1 0 1 0 1 0 1 0 1 0 1 0 0
0 1 0 1 0 1 0 1 0 1 0 1 0 1 0 1 0 1 0 0
0 1 0 1 0 1 0 1 0 1 0 1 0 1 0 1 0 1 0 0
0 1 0 1 2 1 0 1 2 1 0 1 2 1 0 1 2 1 0 0
0 1 0 1 1 1 0 1 1 1 0 1 1 1 0 1 1 1 0 0
0 0 0 0 0 0 0 0 0 0 0 0 0 0 0 0 0 0 0 0
0 1 1 1 1 1 1 1 1 1 1 1 1 1 1 1 1 1 1 1
0 1 1 1 1 1 1 1 1 1 1 1 1 1 1 1 1 1 1 1
0 0 0 0 0 0 0 0 0 0 2 2 0 0 0 0 0 0 2 2
0 0 0 0 0 0 0 0 0 0 0 0 0 0 0 0 0 0 0 0
0 0 0 0 0 0 0 0 0 0 0 0 0 0 0 0 0 0 0 0
0 0 0 0 0 0 0 0 0 0 0 0 0 0 0 0 0 0 0 0
0 0 0 0 0 0 0 0 0 0 0 0 0 0 0 0 0 0 0 0
0 0 0 0 0 0 0 0 0 0 0 0 0 0 0 0 0 0 0 1
3 0 0 0 0 0 0 0 0 0 0 0 0 0 0 0 0 0 0 1
13 1 18 9
13 12 18 17
